NO ./textures/usop_north.xpm

SO ./textures/nami_soth.xpm

WE ./textures/luffy_west.xpm 

EA ./textures/chopper_east.xpm

F 38,111,15

C 255,255,255


        1111111111111111111111111
        1000000000110000000000001
        1011000000110000000000001
        1001000000000000000000001
111111111011000001110000000000001
100000000011000001110111111111111
11110111111111011100000000001
11110111111111011101010010001
11000000110101011100000010001
10000000000000001100000000001
10000000000000001101010010001
11000001110101011111011110N0111
11110111 1110101 101111010001
11110111 1111111 111111111111
10000001
10000001
10000001
10000001111111111111111111111111111111111111
10000000000000000000000000000000000000000001
10000000000000000000000000000000000000000001
10000000000000000000000000000000000000000001
10000000000000000000000000000000000000000001
10000000000000000000000000000000000000000001
11111111111111111111111111111111111111111111111111111111111111111111111111